Abaciscus: (n.) One of the tiles or squares of a tessellated pavement; an abaculus.
Dactylar: (a.) Of or pertaining to a finger or toe, or to the claw of an insect crustacean.
Jointly: (adv.) In a joint manner; together; unitedly; in concert; not separately.
Cabassou: (n.) A species of armadillo of the genus Xenurus (X. unicinctus and X. hispidus); the tatouay.
Glassful: (n.) The contents of a glass; as much of anything as a glass will hold.
Cabaret: (n.) the type of entertainment provided in a cabaret.
Hendecagon: (n.) A plane figure of eleven sides and eleven angles.
Dactylioglyph: (n.) The inscription of the engraver's name on a finger ring or gem.
Eyepiece: (n.) The lens, or combination of lenses, at the eye end of a telescope or other optical instrument.
Babish: (a.) Like a babe; a childish; babyish.
Babiroussa: (n.) Alt. of Babirussa
Fabric: (n.) The structure of anything; the manner in which the parts of a thing are united.
Daemon: (a.) Alt. of Daemonic.
Dactyl: (n.) A finger or toe; a digit.
Abacist: (n.) One who uses an abacus in casting accounts; a calculator.
Abada: (n.) The rhinoceros.
Cabbage: (n.) An esculent vegetable of many varieties, derived from the wild Brassica oleracea of Europe.
Engineering: (n.) Originally, the art of managing engines.
Daedalian: (a.) Cunningly or ingeniously formed or working; skillful; artistic; ingenious.
Abacus: (n.) A calculating table or frame; an instrument for performing arithmetical calculations.
Babirussa: (n.) A large hoglike quadruped.
Dactylioglyphi: (n.) The art or process of gem engraving.
Dactylic: (a.) Pertaining to, consisting chiefly or wholly of, dactyls; as, dactylic verses.
Inexpensive: (a.) Not expensive; cheap.
Aback: (adv.) Toward the back or rear; backward.
Daemonic: (a.) See Demon, Demonic.
Daedalous: (a.) Having a variously cut or incised margin; -- said of leaves.
Dactylet: (n.) A dactyl.
Facet: (v. t.) To cut facets or small faces upon; as, to facet a diamond.
Cabas: (n.) A flat basket or frail for figs, etc.
